%%%%%%%%%%%%%%%%%%%%%%%
%                     %
%                     %
%                     %
%                     %
%                     %
%                     %
%                     %
%                     %
%                     %
%          P          %
%                     %
%                     %
%                     %
%                     %
%                     %
%                     %
%                     %
%                     %
%                     %
%                     %
%                     %
%%%%%%%%%%%%%%%%%%%%%%%
